13 5 2
@@@@@
@W.@@
@...@
@.@@@
@..@@
..@@@
@..@@
@@|@@
@...@
@.@@@
@...@
@.@@@
@$@@@