8 9 1
@@@@@@@@@
@@.W...@@
@@@@.@@@@
@@@...@@@
@.......@
@@@@.@..@
@@@@....@
@@@$.....